#############
#.......#..x#
#....#x##..##
#.#.o...o...#
#..@..~.##.##
#..#........#
#############